subscriptionId = subscriptionId
applicationId = applicationId
tenantId = tenantId
location = location
resourceGroupName = resourceGroupName
vNetName = vNetName
subnetName = subnetName
vNetAddressPrefix = vNetAddressPrefix
subnetAddressPrefix = subnetAddressPrefix
userManagedIdentityName = userManagedIdentityName
servicePrincipalName = servicePrincipalName
displayName = displayName
spPassword = spPassword
roleDefinitionName = roleDefinitionName
vmWinAdminUserName = vmWinAdminUserName
vmWinAdminPassword = vmWinAdminPassword
vmWinName = vmWinName
vmWinSize = vmWinSize
vmWinDiskSizeInGB = vmWinDiskSizeInGB
vmWinPublisherName = vmWinPublisherName
vmWinOffer = vmWinOffer
vmWinSKU = vmWinSKU
vNetName = vNetName
subnetName = subnetName
netSecurityGroupName = netSecurityGroupName
ipConfigurationName = ipConfigurationName
sqlServerName = sqlServerName
elasticPoolName = elasticPoolName
dbName = dbName
sqlAdminUserName = sqlAdminUserName
sqlAdminPassword = sqlAdminPassword
newResourceGroupName = newResourceGroupName
keyVaultName = keyVaultName
secretName = secretName
allowedIPAddresses = allowedIPAddresses
secretValue = secretValue
automationAccountName = automationAccountName
runBookName = runBookName
runType = runType
scheduleName = scheduleName
dayInterval = dayInterval
